R 1440 750
NO textures/log_spruce.xpm
SO textures/log_jungle.xpm
WE textures/planks_jungle.xpm
EA textures/planks_spruce.xpm
S textures/ea.xpm
F 103,61,34
C 30,112,195

111111111111111111111111111111111111111111111111111111111
100000000000000000000000000000000000000000000000000000001
10000000000000000000000000S000000000000000000000000000001
100000000000000000000000000000000000000000000000000000001
100000000000000000000000000000000000000000000000000000001
100000000000000000000000000000000000000000000000000000001
100000000000000000000001101110000000000000000000000000001
100000000000000000000111000011110000000000000000000000001
100000000000000000000000000000010000000000000000000000001
100000000000000000000111110111010000000000000000000000001
100000000000000000000000010101011100000000000000000000001
100000000000000000000000000000000000000000000000000000001
100000000000000000000000000001011100000000000000000000001
100000000000000000000000000001010000000000000000000000001
100000000000000000000000000001010000000000000000000000001
100000000000000000000000000000000000000000000000000000001
100000000000000000000000000000000000000000000000000000001
100000000000000000000000000000000000000000000000000000001
111111111111111111111111111111111111111111111111111111111
