R 800 600
NO textures/grass.xpm
SO textures/brick.xpm
WE textures/stone.xpm
EA textures/metal.xpm
S textures/ea.xpm
F 133,67,27
C 84,255,248

11111111111111111111111
10000000000000000000001
10000000000000000000001
10000000000000000000001
10000000000000000000001
10000001000000000000001
10000000000001000000001
10000000000000000000001
10000000000000000000001
11111111110000111111111
10000000010N00100000001
10000000010000100000001
11111111111111111111111