R 1440 750
NO textures/grass.xpm
SO textures/brick.xpm
WE textures/stone.xpm
EA textures/metal.xpm
S textures/ea.xpm
F 220,100,0
C 225,30,0

11111111111111111111111111111
10000000000000000000000000001
10000000000000000000000000001
10000000000000000000000000001
1000000E0000010000000000000011111
100000000000000000000000000000001
100000000000000000000000000000001
100000000000010000000000000011111
10000000000000000000000000001
10000000000000000000000000001
10000000000000000000000000001
10000000000000000000000000001
11111111111111111111111111111
