R 1920 1080
NO textures/no.xpm
SO textures/so.xpm
WE textures/we.xpm
EA textures/ea.xpm
S textures/ea.xpm
F 220,100,0
C 225,30,0

11111111111111111111111111111
10000000000000000000000000001
10000000000000000000000000001
10000000000000000000000000001
1000000E000001000000000000001
1000000000000000000000000000111111111
1000000000000000000000000000000000001
1000000000000100000000000000000000001
1000000000000000000000000000111111111
10000000000000000000000000001
1000000000000000000000000000111111
1000000000000000000000000000000001
1000000000000000000000000000111111
11111111111111111111111111111
