R 1920 1080
NO ./textures/no.xpm
SO ./textures/so.xpm
WE ./textures/we.xpm
EA ./textures/ea.xpm
S ./textures/we.xpm
F 220,100,0
C 225,30,0

11111111111111111111111111111
10000000000000000000000000021
10111010100000000000000000001
10010010100000000000000000001
10110011100000000000000000001
10000000000000000000000000001
10000000000000000000000000001
10000000000000000000000000001
10000000000000000000000000001
10000000000000000000000000001
10000000000000000000000000001
10000000000000000000000000001
10N00000000000000000000000001
11111111111111111111111111111
