R 1920 1080
NO ./textures/no.bmp
SO ./textures/so.bmp
WE ./textures/we.bmp
EA ./textures/ea.bmp
S ./textures/player_sprite.bmp
F 220,100,0
C 225,30,0

11111111111111111111111111111
10000000000000000000000000021
10000000000000000000000000001
10000000000000000000000000001
10000000000000000000000000001
10000000000000000000000000001
10000000000000000000000000001
10000000000000000000000000001
10000000000000000000000000001
10000000000000000000000000001
10000000000000000000000000001
10000000000000000000000000001
10000000000000000000000000N01
11111111111111111111111111111