R 1080 1080
NO textures/grass.xpm
SO textures/brick.xpm
WE textures/we.xpm
EA textures/ea.xpm
S textures/ea.xpm
F 220,100,0
C 225,30,0

11111111111111111111111111111
10000000000000000000000000001
10101011101110111011100000001
10111010100100010010000000001
10101011100100010011100000001
10101010100100111000100000001
10000000000000000011100000001
10000000000000000000000000001
10000000000000000000000000001
10000000000000000000000000001
10000000000000N00000000000001
10000000000000000000000000001
11111111111111111111111111111
