R 1440 750
NO textures/log_spruce.xpm
SO textures/log_jungle.xpm
WE textures/planks_jungle.xpm
EA textures/planks_spruce.xpm
S textures/stone.xpm
F 103,61,34
C 30,112,195

1111111111111111111111111111111111111111111111111111111111111111111111111111
1000000000000000000000000000000000000000000000000000000010000000000000000001
1000000000000000000000000000000000000000000000000000000010000000000000000001
1000000020000000000000000000000000000000000000000000000010000000000000000001
1000000000000000000000000000000000000000000000000000000010000000000000000001
1000000000000000000000000000000000000000000000000000000010000000000000000001
1000000000000000000000011011100000000000000000000000000011111111121111111111
1000000000000000000001110000111100000000000000000000000010000000000000000001
100000000000000000000000000000010000000000N000000000000000000000000000000001
1000000000000000000001111101110100000000000000000000000010000000000000000001
1000000000000000000000000101010111000000000000000000000011111111121111111111
1000000000000000000000000000000000000000000000000000000010000000000000000001
1000000000000000000000000000010111000000000000000000000010000000000000000001
1000000000000000000000000000010100000000000000000000000010000000000000000001
1000000000000000000000000000010100000000000000000000000010000000000000000001
1000000000000000000000000000000000000000000000000000000010000000000000000001
1000000000000200000000000000000000000000000000000000000010000000000000000001
1000000000000000000000000000000000000000000000000000000010000000000000000001
1111111111111111111111111111111111111111111111111111111111111111111111111111
