R     1400 700
NO    textures/minecraft/orange_wool.xpm
SO    textures/minecraft/blue_wool.xpm
WE    textures/minecraft/red_wool.xpm
EA    textures/minecraft/white_wool.xpm
S     textures/Jord_z_le_fils.xpm
LI    textures/minecraft/heart.xpm
DO    textures/tropical.XPM
CO    textures/planet_rose.XPM
LU    textures/jesus.XPM
C     72,142,150
F     66,150,18

1111111111111111111111111111111111111111111111111111111111111111111111111111
1000000000000000000000000000000000000000000000000000000010000000000000000001
1000000000000000000000111000100000000000200000000000000010000000000000000001
1000000000000000000001000100100011000000000000000000000010000000000000000001
1000000000000000000111110110110100100000222CL0000000000010000000000000000001
10000000000000000001000100100011010000000000011111D1111110000000000000000001
100000000000000000010101101110000100000000000D000000222211111111121111111111
100000000000000000100111000011110100000000000U000000W00010000000000000000001
100000000000000000000000000000010110000000000D000000000000000000000000000001
1000000000000000001001111101110100010000000001111111111110000000000000000001
1000000000000000001010100101010111010000000000000000000011111111121111111111
1000000000000000000000010100000000010000000000000000000000000000000000000001
1000000000000000000000000000010111000000000000000000000010000000000000000001
10000000000000000000000001000101000000000000000000C0000010000000000000000001
1000000000000000000000000100010100000000000000000000000010000000000000000001
1000000000000000000000000000000000000000000000000000000010000000000000000001
1000000000000200000000000000000000000000000010000000000000000000000000000001
1000000000000000000000000000000000000000000000000000000010000000000000000001
1111111111111111111111111111111111111111111111111111111111111111111111111111
