R 1400 700
NO textures/minecraft/orange_wool.xpm
SO textures/minecraft/blue_wool.xpm
WE textures/minecraft/red_wool.xpm
EA textures/minecraft/white_wool.xpm
S textures/minecraft/tnt_side.xpm
C 72,142,150
F 66,150,18

1111111111111111111111111111111111111111111111111111111111111111111111111111
1000000000000000000000000000000000000000000000000000000010000000000000000001
1000000000000000000000000000000000000000000000000000000010000000000000000001
1000000020000000000000000000000000000000000000000000000010000000000000000001
1000000000000000000000000000000000000000000000000000000010000000000000000001
1000000000000000000000000000000000000000000000000000000010000000000000000001
1000000000000000000000011011100000000000000000000000000011111111121111111111
1000000000000000000001110000111100000000000000000000000010000000000000000001
1000000000000000000000000000000100000000000000000000000000000000000000000001
1000000000000000000001111101110100000000000000000000000010000000000000000001
100000000000000000000000010101011100000000000W000000000011111111121111111111
1000000000000000000000000000000000000000000000000000000010000000000000000001
1000000000000000000000000000010111000000000000000000000010000000000000000001
1000000000000000000000000000010100000000000000000000000010000000000000000001
1000000000000000000000000000010100000000000000000000000010000000000000000001
1000000000000000000000000000000000000000000000000000000010000000000000000001
1000000000000200000000000000000000000000000000000000000010000000000000000001
1000000000000000000000000000000000000000000000000000000010000000000000000001
1111111111111111111111111111111111111111111111111111111111111111111111111111
