R     1400 700
NO    textures/minecraft/blue_wool.xpm
SO    textures/minecraft/orange_wool.xpm
WE    textures/minecraft/red_wool.xpm
EA    textures/minecraft/white_wool.xpm
S     textures/Jord_z_le_fils.xpm
LI    textures/minecraft/heart.xpm
DO    textures/tropical.XPM
CO    textures/planet_rose.XPM
LU    textures/jesus.XPM
C     72,142,150
F     66,150,18

11111111111111111111111111111111111111111111
10000000000000000000011000000000000000000001
10C0000000E0000000000DD000000000C00000000L01
10000000000000000000011000000000000000000001
1111111111D111111111111111111111D11111111111
1111111111D111111111111111111111D11111111111
10000000000000000000011000000000000000000001
102000000C00000000000DD000000000C00000000U01
10000000000000000000011000000000000000000001
11111111111111111111111111111111111111111111
