R 1400 700
NO textures/minecraft/orange_wool.xpm
SO textures/minecraft/blue_wool.xpm
WE textures/minecraft/red_wool.xpm
EA textures/minecraft/white_wool.xpm
S textures/minecraft/heart.xpm
C 72,142,150
F 66,150,18

1111111111111111111111111111111111111111111111111111111111111111111111111111
1000000000000000000000000000000000000000000000000000000010000000000000000001
1000000000000000000000111000100000000000000000000000000010000000000000000001
1000000020000000000001000100100011000000000000000000000010000000000000000001
1000000000000000000111110110110100100000002000000000000010000000000000000001
1000000000000000000100010010001101000000000000000000000010000000000000000001
1000000000000000000101011011100001000000000000000000000011111111121111111111
10000000000000000010011100001111010000000000N0000000000010000000000000000001
1000000000000000000000000000000101100000000000000000000000000000000000000001
1000000000000000001001111101110100010000000000000000000010000000000000000001
1000000000000000001010100101010111010000000000000000000011111111121111111111
1000000000000000000000010100000000010000000000000000000000000000000000000001
1000000000000000000000000000010111000000000000000000000010000000000000000001
1000000000000000000000000100010100000000000000000000000010000000000000000001
1000000000000000000000000100010100000000000000000000000010000000000000000001
1000000000000000000000000000000000000000000000000000000010000000000000000001
1000000000000200000000000000000000000000000000000000000000000000000000000001
1000000000000000000000000000000000000000000000000000000010000000000000000001
1111111111111111111111111111111111111111111111111111111111111111111111111111
