R 1700 1000
NO textures/pink2.xpm
SO textures/blue1.xpm
WE textures/rainbow.xpm
EA textures/side.xpm
S textures/side.xpm
F 103,204,250
C 103,204,250

1111111111111111111111111111111
1000000000000000000000000000001
1011101010100101110111111011101
1001001010100101100010010011001
1011001110110101110010010011101
1000000000000000000000000000001
10000N0000000000000000000000001
1011100111011101010010000000001
1010100101010101011010011011001
1011100101011101010110111111101
1010010111011101010010001110001
1000000000000000000000000100001
1111111111111111111111111111111
