R 1400 700
NO textures/pink2.xpm
SO textures/blue1.xpm
WE textures/rainbow.xpm
EA textures/side.xpm
S textures/alpaca_bkg.xpm
LI textures/minecraft/heart.xpm
DO textures/tropical.XPM
CO textures/planet_rose.XPM
LU textures/jesus.XPM
F 103,204,250
C 103,204,250

111111111111111
100000000000001
100E0U000000001
100000000000001
111111111111111
