R 1400 700
NO textures/pink2.xpm
SO textures/blue1.xpm
WE textures/rainbow.xpm
EA textures/side.xpm
S textures/alpaca_bkg.xpm
LI textures/mini_heart.xpm
DO textures/tropical.XPM
CO textures/planet_rose.XPM
LU textures/jesus.XPM
F 103,204,250
C 103,204,250

111111111111111
10C2C2C0C0C0C11
1E0L0C0C0C0C0U1
10C0C0C0C0C0C11
111111111111111
