R 1400 700
NO textures/pink2.xpm
SO textures/blue1.xpm
WE textures/rainbow.xpm
EA textures/side.xpm
S textures/alpaca_bkg.xpm
LI textures/minecraft/heart.xpm
DO textures/tropical.XPM
CO textures/planet_rose.XPM
LU textures/jesus.XPM
F 103,204,250
C 103,204,250

1111111111111111111111111111111
100000000001111H111111000000001
1000000000100000000000100000001
100000000100111H111100000000001
1000000010010000000010000000001
100000010010011H111001000000001
1000000101001000000100100000001
100000010101001H110010100000001
1000000101010100001010100000001
1000000101010E0U101010100000001
1000000101001111001010100000001
1000000100100000010010100000001
1000000010011111100100100000001
100000000100000000100L000000001
1111111111111111111111111111111
