R 1400 700
NO textures/sonic.xpm
SO textures/autorouteduBH.xpm
WE textures/jojo.xpm
EA textures/BH.xpm
S textures/sky_text.xpm
F 103,61,34
C 30,112,195

11111111111111111111111111111
10000000000000000000000000001
10000000000000000000000000001
100000000000000000U0000000001
1000000E0000CCCCCCCCCCCC00001
100000000000CCCCCCCCCCCC00001
100000000000CCCCCCCCCCCC00001
10000000000001000000000000001
10000000000000000000000000001
10000000000000000000000000001
10000000000000000000000000001
10000000000000000000000000001
11111111111111111111111111111
